NAT_ShadowOff	NAT_ShadowOn
ShadowOff	ShadowOn
NAT_ShadowOff_InkOff	NAT_ShadowOn_InkOff
ShadowOff_InkOff	ShadowOn_InkOff
NZ_ShadowOff	NZ_ShadowOn
NZ_ShadowOff_InkOff	NZ_ShadowOn_InkOff
NZAT_ShadowOff_InkOff	HOHO
NZAT_ShadowOff_InkOff	ZAMEN0
NZAT_ShadowOff_InkOff	ZAMEN1
NZAT_ShadowOff_InkOff	ZAMEN2
NAT_AllAmb_ShadowOff	NAT_AllAmb_ShadowOn
NAT_AllAmb_ShadowOff_InkOff	NAT_AllAmb_ShadowOn_InkOff
AllAmb_ShadowOff	AllAmb_ShadowOn
AllAmb_ShadowOff_InkOff	AllAmb_ShadowOn_InkOff
NAT_ShadowOff_BL	NAT_ShadowOn_BL
NAT_ShadowOff_InkOff_BL	NAT_ShadowOn_InkOff_BL
ShadowOff_BL	ShadowOn_BL
ShadowOff_InkOff_BL	ShadowOn_InkOff_BL
NAT_AllAmb_ShadowOff_BL	NAT_AllAmb_ShadowOn_BL
NAT_AllAmb_ShadowOff_InkOff_BL	NAT_AllAmb_ShadowOn_InkOff_BL
AllAmb_ShadowOff_BL	AllAmb_ShadowOn_BL
AllAmb_ShadowOff_InkOff_BL	AllAmb_ShadowOn_InkOff_BL
ShadowOff_Front	ShadowOn_Front
ShadowOff_InkOff_Front	ShadowOn_InkOff_Front
